299999999B999999991
A00000000A00000000A
A02102910A02910210A
A04304930504930430A
A00000000000000000A
A06708069B97080670A
A0000A000A000A0000A
49910D97X5X69C02993
XXXA0AXXXXXXXA0AXXX
999305X27H61X504999
XXXX0XXAXXXAXX0XXXX
999108X49993X802999
XXXA0AXXXXXXXA0AXXX
299305X69B97X504991
A00000000A00000000A
A06106970506970270A
A00A00000000000A00A
D70508069B97080506C
A0000A000A000A0000A
A0699E9705069E9970A
A00000000000000000A
4999999999999999993